   ############################
      #              #     #  #
#  #######  #  ####  #  #  #  #
#           #     #  #  #     #
#  ####..#  #######  #  #  ####
#  #     #  #  #        #  #  #
####  #######  #  #  #  #  #  #
#     #  #  #     #  #  #  #  #
####  #  #  #######  #######..#
#              #              #
#  #  #############  ####  #  #
#  #  #     #     #..#     #  #
####  ####  ####  #  ####  ####
#     #     #     #     #  #  #
#  ####  #  #  ####  #######  #
#  #     #           #     #  #
##########..#######  #  ####  #
#           #     #     #  #  #
#  ####  #  #  #  #  #  #  #  #
#     #  #     #  #  #
############################
